XXXXXXXXX
X H   * X
X X XXX X
X X X   X
X   XXX X
 *X   * X
 XXX XX*X
  X     X
X * X X X
XXF  F  X
XXX XXX X
XXX*XXX X
XXX    *X