XXXXXX
XHXXXX
X*FX X
XXFX X
XFF  X
XXXXXX